12
1,7,5,7,5,7,5,7,5,7,5,6
3,13,6,9,6,9,6,9,6,9,6,10
11,6,9,6,9,6,9,6,9,6,10,10
10,9,6,9,6,9,6,9,6,8,10,10
11,6,9,6,9,4,9,4,8,3,12,10
10,9,6,9,4,3,6,1,5,12,3,14
10,1,12,3,4,9,14,1,5,5,12,10
11,4,3,12,3,4,9,5,5,5,5,12
10,3,12,3,12,3,4,2,3,5,5,6
11,12,3,12,3,12,3,12,11,5,5,14
11,5,12,3,12,3,14,2,11,5,5,14
9,5,5,13,5,13,13,13,13,5,5,12