12
1,5,7,5,5,5,7,5,7,5,5,6
3,5,14,3,7,5,15,4,9,5,7,12
11,6,10,10,9,7,13,6,3,5,13,4
10,9,13,12,3,13,5,12,9,5,7,6
9,5,6,3,15,5,5,7,7,4,10,10
3,5,15,14,10,3,6,10,11,6,10,10
11,7,12,11,12,9,14,9,14,11,13,14
11,15,7,12,2,2,9,6,9,12,3,14
11,12,8,3,14,9,6,9,6,3,14,10
11,6,2,10,8,3,13,6,10,10,10,10
11,13,12,10,2,9,5,14,10,9,13,14
9,5,5,13,13,5,5,12,9,5,5,12